..#.......
..#.......
......###.
#.........
..#......#
..#..#....
.....#.#..
##.......#
##.......#
.......#.#