.#.......#
.#...##..#
.#........
...#.##.#.
........#.
.###...##.
..........
..........
#.....#...
..#.......