#....#.#..
##.#......
..........
...#..##..
..........
.......##.
..........
.....#....
..#..#...#
..#..##.##