#.........
#.##......
..##..#...
..........
.#.#..##..
...#......
.........#
#.#......#
..#...#..#
..#.......