.#.#....#.
..........
..........
.........#
#.#..#...#
..#..#...#
..#.......
#......#..
#.#...##..
..#...#...