..........
......#...
###..##.#.
..........
..........
#.#...#...
#.......#.
........#.
#...#.#...
###.#.....