.......#.#
..#....#.#
.....#...#
..........
......#..#
..##..#...
..#.......
..........
#.###..#..
#.#.......