.#....#..#
.#.......#
...#.#...#
.....#....
.....#....
###..#..#.
..........
..........
#........#
......##.#