........#.
.#...#....
.#...#....
........##
.##......#
.##...#...
....#.##..
.........#
.........#
#.....#...