..#.......
#.#.....#.
#.........
...#......
...#.#..#.
#....##...
#........#
#.#...#...
.....##...
.....#....